주제(한글)	주제코드(영문)
맞춤법	orthography
띄어쓰기	spacing
어휘 뜻	vocabulary
속담	proverb
관용어	idiom
사자성어	sino_idiom
한자어 뜻	hanja_word
중심문장 찾기	main_sentence
문장 순서 배열	sentence_order
주제/제목 고르기	topic_title
사실/의견 구분	fact_opinion
영어 단어 뜻	eng_vocab
영어 문장 의미	eng_sentence
영어 빈칸 채우기	eng_cloze
수학 연산	arithmetic
규칙 찾기	pattern
분수/소수 비교	fraction_decimal
시간/달력 계산	time_calendar
단위 변환	unit_conversion
생활 안전 상식	safety_common

